MAZE: "mylevel",' '
INIT_MAP:solidfill,' '
GEOMETRY:center,center
MAP
-------------
|.....L.....|
|.....L.....|
|.....L.....|
|.....L.....|
|.....L.....|
-------------
ENDMAP
REGION:(0,0,12,6),lit,"ordinary"
$all_map = selection:fillrect (1,1,11,11)
$right = selection:fillrect (11,1,11,5)
BRANCH:(2,2,2,2),(0,0,0,0)
OBJECT:('/',"cold"),(2,2),blessed
